"a" = (/turf/liquid/water{tag = "icon-Water1"; icon_state = "Water1"},/area)
"b" = (/turf/liquid/water{tag = "icon-Water2"; icon_state = "Water2"},/area)
"c" = (/turf/ground/sand{tag = "icon-sand3"; icon_state = "sand3"},/area)
"d" = (/turf/ground/sand{tag = "icon-sand2"; icon_state = "sand2"},/area)
"e" = (/turf/ground/sand{tag = "icon-sand1"; icon_state = "sand1"},/area)
"m" = (/turf/wall/decWall{tag = "icon-Shale"; icon_state = "Shale"},/area)
"p" = (/turf/ground/fertile/grass{tag = "icon-grass1"; icon_state = "grass1"},/area)
"q" = (/turf/ground{tag = "icon-grass1"; icon_state = "grass1"},/area)
"r" = (/turf/ground/sand,/area)

(1,1,1) = {"
aaaaaaaaaaaaabbaaaaaaaaaaaaaaaaaaaaaaaaabaaaabaaaaaaaaaaaabbbaaaaaaaaaaaaaaaaabbaaaaaaaaaaaaaaaaaaaa
aaaaaaaaaaaaababaaaaaaaaaaaaaaaaaaaaaaaabaaaaaaaaaaaaaaaabbbbaaaaaaaaaaaaaaaababaaaaaaaaaaaaaaaaaaaa
aabbbaaaaaabaaabaaaaaaaaaaaaaaaaaaaaaaabaaaaaabaaaaabbbbbbaaaaaaaaaaaaaaaaaaabbbbaaaaaaaaaaaaaaaaaaa
aabbbaaaaaabaaabbbbaaaaaaaaaaaaaabbbbaabaaaaabaaabbbbbbbaaaaabbaaabbaaaaaaaaabbaabaaaaaaaaaaaaaaaaaa
aabbbaaaaaabbbbbaabaaaaaaabbbabbbbbbbaabaaaabaaaabbabbbaabbbbbbbbbaaaaaaaaaabbbaabbaaaaaaaaaaaaaaaaa
aabbbaaaaabbabbaaabaaaaaabaaaaaabbbbabbaaaaaaaaaaaaabbbbbaaaaabbaaaaaaaaaaaabbbaabbaaaaaaaaaaaaaaaaa
aaaabaaaababbbaaabbaaaaaaaaaaaabbaabbabaaaabaaaaaaaaaabaaaaaaaaaaaaaaaaacaababaaabbaaaaabbbbbbaaaaaa
aababaaaaaabbbaabaaaaaaaabaaaaabbabbaaabbbbaaaaaaaaaaabaaaaaaaaaaaaaaaccccababbbbbbbbbbbbbbbaabaaaaa
aababbaaabbbbbbbbaaaaaaabaaaaaabaabbaaaaaaaaaaaaaaaaaabbaaaaaaaaaaaaacccccabbabbbaaaaaabababbbbaaaaa
aaababaaabbbbbbaabaaaaaabaaaaaababbabaaaaaaaaaaaaaaaabbbbbbaaaaaaaaacccccccaaaaaaaaaaabaababbbaaaaaa
aaaaabaaabbbaaabbbbaaabbaaaaaaababbbbaaaaabbaaaaaaaabbaaabbbaaaaaacccccdccccaaaaaaaaaabaababbbaaaaaa
aaaaabbbbbbbaaaaaaabbbaaaaaaaaabbabbaaaaababaaaaaaabbaaaababaaaaaacccecdeeccaaaaaaaaaabaababbaaaaaaa
aaaaaaaaaaaaaaaaaaaaaaaaaaaaaaaabbbbaaaaababaaaaaabbbaaabbbbaaaaaacceeddeeeccaaaaaaaaaabababbaaaaaaa
aaaaaaaaaaaaaaaaaaaaaaaaaaaaaaaaabaaaaabbaaaaaaaaaaabaabbabbaaaaaaaceeddeeeccaabbbbabbbbaabaaaaaaaaa
aaaaaaaaaaaaaaaaaaaaaaaaaaaaaaaaabababaaaaabaaaaaaaabbbaaabaaaaaaaaceeddeeecccbaaabbbaaaaaaaaaaaaaaa
aaaaaaaaaaaaaaaaaaaaaaaaaaaaaaaabbbaaaaaaabbaaaaaaaaaaaaaaaaaaaaaaaceccdeeeeccbaabaabaaaabbaabbaaaaa
aaaaaaaaaaabbaaaabbbbbaabbbbbabbabaaaaaaaabaaaaaaaaaaaaaaaaaaaaaaaccccdcdeeecccaabbbbaaaaabbbbbbaaaa
aaaaaaaaaabbbbbbbbbabbbbbbbbaaaaaaabaaaaabbaaaaaaaaaaaaaaaaaaaaaaaeecededceeeccabbabbbaaaabbbbbbaaaa
aaaaaaaaaabbbabbaaaaaaaabbbbaaaaaaaabaaabbaaaaaaaaaaaaaaaaaaaaaaaceccddcceceeccababbbbbbbbabaaabbaaa
aaaaaaaaababbbbbaaaaaaaaabbbbaaaaaaaababaaaaaaaaaaabaaaaaaaaaaaaccedddceeccceccabbbaababaabbaaabbbaa
bbbaaaabbbbbbaaabbbbbabbbababaaaaaaaaaaaaaaaaabaabbbaaaaaaaaccccedddcceceeeeeccabbaaababaabbaaabbbaa
baababbbbbbbbbabbbaaaaaaabbbbaaaaaaaaaaaaaaaabbababbaaaaaaaacddddececccceeccccpabbaabaabaabbabbaabba
baabbababbaaababaaaaaaaaaaabbaaaaaaaaaaaaaabbbbbaabaaaaaaaapppppppepccccecccccppabbbaaabaabbbabbaaaa
babbaabbbbaaaabbaaaaaaaaaaaaaaaaaaaaabbaaababbaaabbaaaaaaappppppppppppppcccccpppaaaabbbaababbbabaaaa
bbbaabbabbaaaaaabbaaaaaaaaaaaaaaaaaabbaabbabbaaaabaaaaaaapppppppppppppppppccppppaaaaaaaabaabbbbaaaaa
bbabbababbaaaaababaaaaaaaaaaaaaaaaabbbabaabbaaaaaaaaaaaapppppppppppppppppppppppppaaaaaaabaaaaaaaaaaa
abbaaabaabaaaabaabaaaaaaaaaaaaaaaaabbbaaaaaaaaaaaaaaaaaappppppppppppppppppppppppppaaaaaabaaaaaaaaaaa
aaaaaabaaaaaacccccccaaaaaaaaaaaabaaaaaaaaaaaaaaaaaaaaaappppppppppppppppppppppppppppaaaababbbaaaaaaaa
aaaaaabaaaaaccccccccaaaaaaaaaaaabaaaaaaaaaaabbaaaaaaaaapppppppppppppppppppppppppppppaaaabaabbaaaaaaa
aaaaaabbaaaaccdcccccaaaaaaaaabaabaaaaaaaaaaabbaabaaaaappppppppppppppppppppppppppppppaaabbbabaaaaaaaa
aaabbabbaaaaccdccccccaaaaaaaabbabaaaaaabbabbbbaaabaaappppppppppppppppppppppppppppppmbbbaabaabbaaaaaa
aaabbbbbbaaacdcedcccccaaaaaaaababaaaabbbbbbbbaaababpppppppppppppppppppppppppppppppmmaabaaababaaaaaaa
aabababbbabbcdceedceeccaaaaaaaaabbabbbbbbbbbbaaaaabpppppppppppppppppppppppppppppppmaaabaaaabbaaaaaaa
aababaabbbaacdcceeeeccccaaaaaaaaaababbaababbaaaababpppppppppppppppppppppppppppppppbbaabbaaaabaaaaaaa
aabbaabbbaaapcdddcdcddcccaaaaaaaaaaaaaaabbbbaaaaabbmppppppppppppppppppppppppppppppbabbbbbbaabaaaaaaa
aabbababbaabpccccccccdddccccaaaaaaabaaaaabbbaaaaabbmmppppppppppppppppppppppppppppppabbabbababaaaaaaa
aabbbaabaabappppccppcccdddccccaabbbbbaaaaabbaaaaaabbmpppppppppppppppppppppppppppppppbbbabbbbbaaaaaaa
aaaaaaaaaabapppppppppppccdcccccbbbbbabaaaaaaaaaabbaapppppppppppppppppppppppppppppppppaaaaaabbaaaaaaa
aaaabbbaabaampppppppppppceeeccccccbbbabaaaaaaaaabapppppppppppppppppppppppppppppppppppaaaaaaabbaaaaaa
aaabbabaabaammppppppppppppcdecccccccccccccccpppppppppppppppppppppppppppppppppppppppppbbbbbaaaabaaaaa
aaabbbbbbbaaammmpppppppppppddeccccccccccccccppppppppppppppppppppppppppppppppppppppppmaaaabaaaabaaaaa
aaabbabbaaaaabmmmppppppppppccceeeeeeeccccccpppppppppppppppppppppppppppppppppppppppppmaaaabbbbbabaaaa
aababbbaaabbbbaammppppppppppcccccccceeeeccppppppppppppppppppppppppppppppppppppppppppaaaabbaaaabaaaaa
aababbbbbbbaabaaampppppppppppppppccccccccppppppppppppppppppppppppppppppppppppppppppmaaaaaaaababaaaaa
aabbaabaaaaaabaaaapppppppppppppppppccccccppppppppppppppppppppppppppppppppppppppppppmaaaaaabaabbaaaaa
aaaaaaaabbaaabaappppppppppppppppppppppppppppppppppppppppppppppppppppppppppppppppppmaaaaaaabbbbaaaaaa
aaaaaaabbbaaaabappppppppppppppppppppppppppppppppppppppppppppppppppppppppppppppppppmbaaaaaaaaaaaaaaaa
aaaaaabbbaaaaabpppppppppppppppppppppppppppppppppppppppppppppppppppppppppppppppppppbbaaaaaaaaaaaaaaaa
aaaaabbabaaaaabppppppppppppppppppppppppppppppppppppppppppppppppppppppppppppppppppmbbaaaaaaaaaaaaaaaa
aaaabbbbbbbbbappppppppppppppppppppppppppppppppppppppppppppppppppppppppppppppppppmmbbbaaaaaaaaaaaaaaa
aaaabbbbbaaaabppppppppppppppppppppppppppppppppppppppppppppppppppppppppppppppppmmmabbbabaaaaabbaaaaaa
aaabbbbabbaaaappppppppppppppppppppppppppppppppppppppppppppppppppppppppppppppppmmaaaaaabaaaabbaaaaaaa
aabaabbbbabaaappppppppppppppppppppppppppppppppppppppppppppppppppppppmmmpppppppaaaaaaaabaaabbaaaaaaaa
aababbaaabbaappppppppppppppppppppppppppppppppppppppppppppppppppppppmmmmmmpppppaaaaaaaabaabbbaaaaaaaa
abaabaaaabbbpppppppppppppppppppppppppppppppppppppppppppppppppppppmmmmmmmmeppmmaaaaaaaababbbaaaaaaaaa
abaaaaaabbbppppppppppppppppppppppppppppppppppppppppppppppppppmmmmmmmmccmmemmmmaaaaaaaabbbbaaaaaaaaaa
aabaaaabaabppppppppppppppppppppppppppppppppppppppppppppppppppmmmmmmmcccdddmmmaaaaaaaaabbbaaaaaaaaaaa
aaabaaabaaappppppppppppppppppppppppppppppppppppppppppppppppppccccccccccdaaaaaaaaaaaaaaaabaaaaaaaaaaa
aaaabbbaaaappppppppppppppppppppppppppppppppppppppppppppppppppccccccccccaaaaaaaaaaaaaaaabaaaaaaaaaaaa
aaaaaaaaaaappppppppppppppppppppppppppppppppppppppppppppppppppcccccccccaaaaaaaaaaaaaaaaabaaabbaaaaaaa
aaaabaaaaabppppppppppppppppppppppppppppppppppppppppppppppppppaccccccaaaaaaaaaaaaaaaaaaabbbbbbaaaaaaa
aaabbaaabbappppppppppppppppppppppppppppppppppppppppppppppppppaaaaaaaaaaaaaaaaaaaaaaaaabbaaabaaabaaaa
aaabbaaabaappppppppppppppppppppppppppppppppppppppppppppppppppaaaaaaaaaaaaaaaabbaaaaabbbbaabbaabaaaaa
aaabbaabaaappppppppppppppppppppppppppppppppppppppppppppppppppaaaaaaaaaaaaaaabbaaaaabababaabaabbaaaaa
aaabbaabaapppppppppppppppppppppppppppppppppppppppppppppppppppaaaaaaaaaaaaaabbaaaaabbbababbaaabaaaaaa
aaabaaabappppppppppppppppppppppppppppppppppppppppppppppppppppaaaaaabaaaaaabbaaaabbabaababbaabaaaaaaa
aaabbbappppppppppppppppppppppppppppppppppppppppppppppppppppppaaaaaabaaaabbbaaaaabaabaabbababbabbaaaa
aaabaaappppppppppppppppppppppppppppppppppppppppppppppppppppppaaaaaabaaabbbbaaaaaaabaaabbbabaaabaaaaa
aabbbbpppppppppppppppppppppppppppppppppppppppppppppppppppppppaaaaabaaabbbbaaaaaaabbaabbbabaaaabaaaaa
aabbabpppppppppppppppppppppppppppppppppppppppppppppppppppppppaaaabbaabbbbaaaaaaaabbbbabaabbaabbaaaaa
aabaapppppppppppppppppppppppppppppppppppppppppppppppppppppppmaaaababbbbbaaaaaaaaaabaabbbbbbaaabbaaaa
aabaappppppppppppppppppppppppppppppppppppppppppppppppppppppmmaaaabbaabaaaaabaaaaabaaabbaaabaaabaaaba
aaaaappppppppppppppppppppppppppppppppppppppppppppppppppppppmaaaaaaaaaaaaaaabaaaabaaaaaaaaabaabaaaaab
aaaaapppppppppppppppppppppppppppppppppppppppppppppppppppppmaaaaaaaaaaaaaaabaaaabaaaaaaaaaabaabaaaaaa
aaaaappppppppppppppppppppppppppppppppppppppppppppppppppppmmaaaaaaaaaaaaaaabaabbbaaaaaaaaaabaabaaaaaa
aaaaampppppppppmmmpppppppppppppppppppppppppmmmpppppppppppmaaaaaaaaaaaaaaaabbbbbaaaaaaaaaaabaabaaaaaa
aaaabmmmmppppmmmmmmppppqqqppppppppppppppppmmmmmpppppppppmaaaaaabaaaaaaaaabbbbbbaaaaabaaabbbbbbaaaaaa
aaabbbmmmmppmmmmmmmpppqqqqqpppmmmmmmmmmmmmmmmmmmmmpppppmmaaaaabbaaaaaaaaaaabbabbbbbbbabaaabbbaaaaaaa
aaabbbbbmmmmmmmccmmmpqqqqqqqpmmmmmmmmmmmmmmmcmmmmmmpmmmmaaaaabbaaaaaaaaaaaabaaaabaababaabbbbbaaaaaaa
aabaabbbbmmmmddcccmmmmmmemmmmmmmccccccmmmmccccccccmmmmmaaaaaabaabbaaaaaaaaaaaaaabbababbbbbbbbaaaaaaa
aabbbaabbbbddddccccmmmmmemmmmmmcddccccccccccccccccmmmaaaaaaabbbbbbaaaaaaaaaaababbabbbabbabbabaaaaaaa
abbaaaabaaaabaacecccccccrcccccccdddedddcccceecccaaaaaaaaaaaaaaaabbaaaaaaaaaabbbaaaaaababbaaabaaaaaaa
bbbbbabbaaaabaaaceecccccccrrcceccdcccceddcceeccaaaaaaaaaaaaaaaaabaaaaaaaabbbbaaaaaabbabbaaaabaaaaaaa
aaaababaaaaaabaaaceeerrrrrrccecddccaacccecceccaaaaaaaaaaaaaaaaabaaaaaaaabbbbaaaaaabbbbaaaaaabaaaaaaa
aaaababaaaaaabaaaaccceeeeccceddcaaaaaacccececcaaaaaaaaaaaaaaaaabbbbbbabbbbbbaaaaaabbaaaaaaabaaaaaaab
aaaabbaaaaaaabaaaaccccceccceeccaaaaaaaaacceeccaaaaaaaaaaaaaaaaaaaaaaaaaaabbaaaaaaaabaaaaaabbaaaabbba
aaaabbaaaaaaaabaabbbcccceceeeccaaaaaaaaaacccccaaaaaaaaaaaaaaaaaaaaaaababbbaaaaaaaaaababbbbbbaaabaaaa
aaaabaaaaaaaaabbbaaaaacceeccccaaaaaaaaaaacccccaaaaaaaaaaaaabbbabbabbbbbbaaaaaaaaaaaabbbbabbaaabaaaaa
aaabaaaaaaaaaaaaaaaaaaccccccccaaaaaaaaaaacccccaaaaaaaaaabbbbbbbbbbaaaaaaaaaaaaaaabbbbbabbbaaabaaaaaa
aaabaaaaaaaaaaaaaaaaaaaccccccaaaaaaaaaaaaacccaaaaaaaaaabaaaaaaaaaaaaaaaaaaaaaaaabbbbaabbbababaaaaaaa
aabbaaaaaaaaabaaaaaaaaaaaaaaaaaaaaaaaaaaaaaaaaaaaaaaaabaaaaaaaaaaaaaaaaaaaaaaaaabbbaaabbbbaaaaaaaaaa
aabbaaaaabbbbbaaaaaaaaaaaaaaaaaaaaaaaaaaaaaaaaaaaaaaabaaaaaaaabbbbbbbaaaaaabbaababaaabbbaaaaaaaaaaaa
abaabbbbbaaabaaabaaaaaaaaaaaaaaaaaaaaaaaaaaaaaaaaaaabaaaaaabbbbaaaaabbabbbaabbaabbaaabaaaaaaaaaaaaaa
baabbaaaaaabbabbbaaaaaaaaaaaaaaaaaaaaaaaabbbbbaaabbbaaaaabbbbaaabbabbabbbbbbbaabaaaabaaaaaaaaaaaaaaa
bbbabaaaaabbbbaabaaaabbbaaaaaaaaaaaabbbabaaabbabbbbaaaaaaabbbbbaaabbaaaaaaabaabbaaaabbbbbbbbaaaaaaaa
baaabbaaabbbbaaabbbbbaaaaaabaaaaaaaabbbbbbbbbbbbababbbbaaaaaaaabbabbbbaaaabbbbaaaaabbbbababaaaaaaaaa
aaaaabbbbbbbaabbbbabbabbabbbbaaaaaaabbaaaabbbbbbbbaabbbbbaaabbbbbbaaabbaababbabbbbbabbabbbbaaaaaaaaa
aaaaaaabbbbbbbbbabbabbbbbbbaaaaaaabbbaaaaaaaaaabbabbbbbaabababbbbaaaababbbbbbbaaaaabbababbaaaaaaaaaa
aaaaaaabbaaaaaaaabaaabbbaabbbbbbbbaaaaaaaaaaaababbbabbbbbaaaaaaaaaaaabaaabbaaaaaabbbbbababaaaaaaaaaa
aaaaaaaaaaaaaaaaabbbbaaaaaaaaabbaaaaaaaaaaabbbbbbaaaaaaaaaaaaaaaaaaaaaaabbaaaaaabbbbbbbbbbaaaaaaaaaa
"}
