"a" = (/turf/ground{tag = "icon-snow"; icon_state = "snow"},/area)
"b" = (/turf/ground{tag = "icon-ice"; icon_state = "ice"},/area)
"c" = (/obj/Spawn{name = "Ice Spawn"; tag = "Ice"},/turf/ground{tag = "icon-ice"; icon_state = "ice"},/area)

(1,1,1) = {"
aaaaaaaaaaaaaaaabbbbbaaabaaaaaaaaaaaaaaaaabaaabaaaaaaaaaaaaaaaaaaaaaabbaaaabaabaaaaaaaaaaaaaaaaabbaa
aaaaaaaaaaaaaaabbbaaaaaabaaaaaaaaaaaaaabaaaabbaaaaaaaaabaaaaaaaaaabaaaabbbbbbbabaaaaaaaaaaaaaaabbaaa
aaaaaaaaaaaaaabbbaaaaaaabaaaaaaaaaaaaaaaabaaababaaaaaabaabaaaaaabaaaaaaaabaaaaaaaaaaaaaaaaaaaabaaaaa
aaaaaaaaaaabbbaaaaaaaaaaabbbbbaaaaaaaaaabaaaaababbaaaabbabbbbaabbaaaaaaaaaabaaaaaaaaaaaaaaaaaabaaaaa
aaaaabaaabbaaaaaaaaaaaaabbaababaaaaaaaaaaaaaaaabaabbabbbbbbbbbbaaaaaaaabbbbaaaabbaaaaaaaaaaaabaaaaaa
aaabbbbbaaaaaaaaaaaaaaabbabbbbbbbbaaaaaaaaaaaaaabaaaaabbbaaaaaabaaaaaaaabaababaaaaaaaaaaaaaaabaaaaaa
aaaaabbbbaaaaaaaababbbbbabaaaaaaaabaaaaaaaaaaaaaabaaabaabaaaaaabaaaaaaaaaaaaaaaaaaaaaaaabaaabaaabbba
aaaaaaaaabaaaabbbaaaaaabaaaaabaaaabaaaaaaaaaaaaaaaabbaaababababbaaaaaaaaaaaaaaaaaaaabaaaaabbbbbbbaaa
aaaaaaaaaabbbbaaaaaaaaabaaaabaaaaabbbbaaaaaaaaaaaaaaaaaaabaaaaaaaaaaaaaaabaaaaaaaaabaaaaaaaaababaaaa
aaaaaaaaaaaaaaaaaaaaaaabaaabbaaaaabaaabaabaaaaaaaaaaaaaaabaaaaaaaaaaaaaaabaaaaaaabbbaaaaaaaaaaaaaaaa
aaaaaaaaaaaaaaaaaaaaaaabbbbaaaaaaabbbbbbbaabbbaaaaaaaaaaaabaaaaaaaaaaaaaaabaaabaaaaaaaaaaaaaaabaaaaa
aaaaaaaaaaaaaaaaaaaaaaaaaaaaaaaaaaaaaabbbbbbabbaaaaaaaaaaaaaabaaaaaaaaaaaaaaaaaaaaaaaaaaaaaabbaaaaaa
aaaaaaaaaaaaaaaaaaaaaaaaaaaaaaaaaaaaaaaaabaabaabaaaaaaaaaaaaaababaaaaaaaaababaaaaaabbbbaaaabaaaaaaaa
aaaaaaaaaaaaaaaaaaaaaaaaaaaaaaaaaaaaaaaabbabaaaaaaaaaaaaaaaaaabaaaaaaaaaabaababaabbbabaaaaaaaaaaaaaa
aaaaaaaaaaaaaaaaaaaaaaaaaaaaaaaaaaaaaaabbbaaaabaaaaaaaaaaaaaaabaabbaaaaaabaabbaaabbbbaaaaaaaaaaaaaaa
aaaaaaaaaaaaaaaaaaabbbbbbbaaaaaaaaaaaaabbaaaabaaaaaaaaaaaaaaaabbbbbaaaaaabaaaaaaabaaaaaaaabaaaaaaaaa
aaaaaaaaaaaaaaaabbbbaaaaabbaaaaaaaaaaaababbabaaaaaaaaaaaaaaaaaabbaaaaaaabaaaaaaaabaaaaaaaaaaaaaaaaaa
aaaaaaaabbabbbbbbaaaaaaabaabbaaaaaabaabbbbbbaaaaaabbaaaaaaaaaaabbaaaaaabaaaaaaaaaabaaaabbbabaaaaaaaa
aaaaaabbaaaaaaaabbaaabbbaaaaaababbbbbbaaaaabaaaaaaaabaaaaaaaabbbbbbaaaacaaaaaaaaaaaabaaaabaabaaaaaaa
abbbbaabaaaaaaaaaabbbaaaaaaaaaabbaaaaaaaaaaaaaaabbaaaaaaaaaabbababbbaaabaaaaaaaaaaaaabaaaaaaaaaaaaaa
ababbaabaaaaaaaaaaaaaaaaaaaaaababbaaaaaaaaaaabaaaaaaabaaaaabbaaaaaaaaaabaaaaaaaaaaaaaaabbbbbaaaaaaaa
abbbaaabaaaaaaaaaaaaaaaaaaaaaabbbbabaaaaaaaaabaaaaaaaabaaaaaaaabaaaaaaabaaaaaaaaababaabaaabaabaaaaaa
abaaaaabaaaaaaaaaaaaaaaaaaaaabababaaaaaaaaaabaaaaaaaaaabaaaaaaabaaaaaabaaabaaaabaaaaabbbaaaaaaaaaaaa
abbaaabaaaaaaaaaaaaaaaaaaaaaababbabaaaaaaaabababbabbaaaabaaaaaabaaababaabaaaabbaaaaaabbbaaabaaaaaaaa
aaabbbbaaaaaaaaaaaaaaaaaaaaaaababaaaaaaaaaabbbaaaaaabbbabbaaaaaaaabababbbabaaababbababbaaaaaaaaaaaaa
aaaaaaaaaaaaaaaaaaaaaaaaaaaaaababbaaaaaaaaaaabaaaaaaaaaaabbaaaabaaabbbbbbaaaaaaaaaaaabaaaabaaaaaaaaa
aaaaaaaaaaaaaaaaaaaaaaaaaaaaaaaabaaaaaaaaaaaaabaaaaaaaaabaabbaabbbbbaabaaaaaaaaaaaaaabaabbaaaaaaaaaa
aaaaaaaaaaaaaaaaaaaaaaaaaaaaaaaaaaaaaaaaaaabbbbaaaaaaaabaaaaababbbaaaaaaaaaaaaaaaaaaaabbaaaaaaaaaaaa
aaaaaaaaaaaaaaaaaaaaaaaaaaabaaaaaaaaaaaaabbaaaaaaaaaabaaaaaaaaabbbaaababaaaaaaaaaaaaaaaaaaaaaaaaaaaa
aaaaaaaaaaaaaaaaaaaaaaaaaabbaaaaaaaaaaaabaaaaaaaaaabaaaaaaaaaaaaabaaaaaabaaaaaaaaaaaaaaaaaaaaaaaaaaa
aaaaaaaaaaaaaaaaaaaaaaaabaabaaaaaaaaaaabaaaaaaaaaabaaaaaaaaaaabaabbbbaaaabaaaaaaaaaaaaaaaaaaaaaaaaaa
baaaaaaaaaaaaaaaaaaaaaaabaabaaaaaabaaaabaaaaaaaaaabaaaaaaaaaaaaaaabbabababaaaaaaaaabbabababbaaaaaaaa
baaaaaabbbbbbbbbbbbbbaaabaabaaaaaababbbbaaaaaaaaaabaaaaaaaaaaaaaaabbbaaaabaaaaaaabbbbaaaaaaaaaaaaaaa
baaaabbaaaaaaabbbbbbaaaabbbaaaaaaabbabbbbabbbbbbaabaaaaaaaaaaaabbababbbbbbbbbabaaaaaaaaaaaaaaabaaaaa
baabbaaaaaaaaabbbaaabbbbbbbbbbbbbbbabaaaaaaaaaabababaaaaaaaaaaaaaababbababbaaaabbbbbbaaaaaaaaaaaaaaa
bbbabaaaaaaaaabaaaaaaaaaaaaaaaaabbbaaaaaaaaaaaababbaaaaaaaaaaaaaaabbabbbbbbbbbaabbbabbabaaaaaaaaaaaa
baaabaaaaaaaaaaaaaaaaaaaaaaaaaabaaaaaaaaaaaaaaaabbaaaaaaaaaaaaaaaaaabbbbabbabbaaaaaaaababbbbbbabaaaa
bababaaaaaabbaaaaaaaaaaaaaaaaaababbbbaaaaaaaaaaabbaaaaaaaaaaaaaaaaaaaaabaaaaaaaaabbbaaaaabbaaaaaaaaa
bababaabbbbbbbaaaaaaaaaaaaaaaaababaabaaaaaaaaaaaabaaaaaaaaaaaaaaaaaaaaaaaaaaaaaaaaaaaaaaabaaaaaaaaaa
bbbabaabaaabbaaaaaaaaaaaaaaaaababbaaaaaaaaaaaaaaaaaaaaaabaaaaaaaaaaaaaaaaaaaaaaaaaaaaaaabaaaaaaaaaaa
abbbbabaaaabaaaaaaaaaabaaabbbbaabaaaaaaaaaaaaaaaaaaaaabaabaaaaaaaaaabbabbaaaaaaaaaaaaaaabaaaaaaaaaaa
aabbbabaaabaaaaaaaaaaaababbbabbabaaaaaaaaaaaaaaaaaaaabbbabbbaaaaaabaaaabbaaaaaaaaaaaaaaabaaaaaaaaaaa
aabbbbabbabaaaaaaaaaaaababbbabaabaaaaaaaaaaaaaaaaaaabbbbbbbbaaaaabaaaaaabbbbabaaaaaabaabbaaaaaaaaaaa
aaabbbbabbbaaaaaaaaaaaabbbabbbabbaaaaaaaaaaaaaaaaaabbaaaaaaaabaaaaaaaaabbaaaaaabbbaaaaaabaaaaaaaaaaa
aaabbbbaaaaaaaaaaaaaaaaabbbbababaaaaaaaaaaaaaaaaaabbaaaaaaaaaababbabbabbaaaaaaaaaaaaaaaabaaaaaaaaaaa
aaabbbbaaaaaaaaaaaaaaaaabbbbabaabbaaaaaaaaaaaaaaaabaaaaaaaaaabbbaaaaaaaaaaaaaaaaaaaaaaaabaaaaaaaaaaa
aabbbbabaaaaabbbaaaaaaaaababbbbbaaaaaaaaaaaaaaaaaabaaaaaaaabbbbbaaaaaaaaaaaaaaaaaaaaaaabaaaaaaaaaaaa
aababbabaaaabbabaaaaaaaabaaaabaaaaaaaaaaaaaaaaaaaabaaaaaaaabbbbaaaaaaaaaaabaaaaaaaaaaaaaaaaaaaaaaaaa
aabaabbabaaaabbaabbaaaabbaabbaaaabaaaaaaaaaaaaaaaaabaaaaaaabaabbaaaaaaaaabbaaaaaaaaaaaaaaaaaaaaaaaaa
aabbabbabbaaaabbbbbbbaaababaaaaabaabaaaaaaaaaaaaaabbbbbbbbbbbaabbaaaaaaabbbbaaaaaaaaaaaaaaaaaaaaaaaa
aaabbbabbabbbbaabbaaabbbbbaaaaaabaaabaabaaabbaaabbaaabbabbaabbbbaaaaaaabbbaaabbbbaaaaaaaaaaaaaaaaaaa
aaaaaaaabbaabbaaabbaaaaaaaaaaaaabaaaababbbbababbaaaaaaaaaaaaaaababbbbababbaaaaaaaaaaaaaaaaaaaaaaaaaa
aaaaaaaaabbbabaaaabbbbbaaaaaaaaabaaaabbbbbbbbbaaaaaaaaaaaaaaaaaaaaaaabbbbaaaaaaaaaaaaaaaaaaaaaaaaaaa
aaaaaaaaaaabbbaaaaaabbbbaaaaaaaabbaaabbaabaaaaaaaaaaaaaaaaaaaaaaaaaaababbaaaaaaaaaaaaaaaaaaaaaaaaaaa
aaaaaaaaaabbbbaaabbbaabbbbabaaaaaabbbbabbaaaaaaaaaaaaaaaaaaaaaaaaaaaabbbabbbbaaaabbbbbbaaaaaaaaaaaaa
aaaaaaaaaababbbbbaaaaaaaaabbbaaabaababbbaaaaaaaaaaaaaaaaaaaaaaaaaaaaabbbbbbaaaaaabbaaabaaaaaaaaaaaaa
aaaaaaaaaababbaaaaaaaaaaaaaabababababbaabbbbaaaaaaaaaaaaaaaaaaaaaaaaaaaaaaaaabbbbbbaaaabaaaaaaaaaaaa
aaaaaaaaaababaaaaaaaaaaaaaaaababbbaaaaaaaaaabbaaaaaaaaaaaaaaaaaaaaaaaaaaaaaaabaabbabaaabbaaaaaaaaaaa
aaaaaaaaaabbbbbbaaaaaaaaaaaaabbbabaaaaaaaaaaabbaabbbaaaaaaaaaaaaaaaaaaaaaaaaabaaabaabaaabaaaaaaaaaaa
aaaaaaaaaabbbbbbbaaaaaaaaabaabaabaaaabbbbbbbbbabbaabaaaaaaaaaaaaaaaaaaaaaaaaaaaaabbbbbbbaaaaaaaaaaaa
aaaaaaaaaabbbbbbbbbbbbbaababbbabbaaaabbbabaaabbaaabaaaaaaaaaaaaaaaaaaaaaaaaabaaaabbaabbbaaaaaaaaaaaa
aaaaaaaaaabbbbbababbaaabbbabaabbbaaaaaaaaaaaabaaaabaaaaaaaaaaaaaaaaaaabbbaaabaaaabbbbbbbaaaaaaaaaaaa
aaaaaaaaaabbbbbbbabbbabaababbbbbaaaaaaaaaaaaabaaaabaaaaaaaaaaaaaaaaabaabbbbbbaaaabbbbbaabaaaaaaaaaaa
aaaaaaaaaaabbbbbbbbbbbaaabbbbbbaaaaaaaaaaaaaabaaabaaaaaaaaaaaaaaaabaaabbbbbaaaaaabbbbbabbbbbbaaaaaaa
aaaaaaaaaaaaaaabbbbbbbaabbbbbbbbbaaaaaaaaaaaaababaaaaaaaaaaaaaabbbbabbbaabaaaaaaabbbabbaabbbbbaaaaaa
aaaaaaaaaaaaaaaabbbbbbbbbbaaaababbaaaaaaaaaaaababaaaaaaaaaaabbbbbaaabbabbabbbbaaabababaaaaaaaaaaaaaa
aaaaaaaaaaaaaaaaaabbbbbbbbaaaaabbbbaaaaaaaaaaabbaaaaaaaaaabbbbbbbbbbbbabaaaaabaaabababaaaaaaabbaaaaa
aaaaaaaaaaaaaaaaaabbbbbaaaaaaabbbbbbaabbaaaaaaaaaaaaaaaaaabbbabbbbaabaaaaaaaaaaabaaaabaabaaabaabaaaa
aaaaaaaaaaaaaaaaaaabbbaaaaaaaabbbbbbaababaaaaaaaaaaaaaaaaaabaaabaaaabbaaaaaaaabbbabaabaaaaabaaaaaaaa
aaaaaaaaaaaaaaaaabbbbaaaaaaaaaababbbbabbabbbabbaaaaaaaaaaabaaaabaaaaaaaaaaaaaaabbbaabbabbaaaaaabbaaa
aaaaaaaaaaaaaaaabbbbaaaaaaaaaaababbbbbabaaaaaaabbaaaaaaaabaabbbbaaaaaaaaaaaaaaabaaaaaababbbaaababbaa
aaaaaaaaaaaaaaaabbbbaaaaaaaaaaaabbbbbbbaaaaaaaaaabbbbbaaaaaaaaaaaaaaaaaaaaaaaabaaaaaaaaabbbaabaaaaaa
aaaaaaaaaaaaaaaabbbbaaaaaaaaaaaaabbbbaabaaaaaaaaaabbbbbbabbbaaaaaaaaaaaaaaaaabbaaaaaaaaaaaabbaaaabaa
aaaaaaaaaaaaaaaabbbbbaaaaaaaaaaaaabbbaabaaaaaaaaaaabbbbbbbabaaaaaaaaaaaaaaaaabbaaaaaaaaabbaabaaaaaba
aaaaaaaaaaaaaaabbbbbaaaaaaaaaaaaaabbbbbbaaaaaaaaabbbabbbbaabaaaaaaaaaaaaaaaabbabababbaababaaaaaaaaaa
aaaaaaaaaaaaaabbbbbaaaaaaaaaaaaaaaabaabbaaaaaaaabbaaaaaabbbbaaaaaaaaaaaaabaabbbaaaaaabbaaaaaaaaaaaaa
aaaaaaaaaaaaaabbbbbbaaaaaaaaaaaaaaabaaaaaaaaaaaaaaaaaaaababbaaaaaaaaaaaaaaababaaaaaaabbaabaaaaaaaaaa
aaaaaaaaaaaaaabbbbbbaaaaaaaaaaaaaaabaaaaaaaaaaaaaaaaaaaababbaaaaaaaaaaaabaaabaaaaaaabababaaaaaaaaaaa
aaaaaaaaaaaaabbbbbbbaaaaaaaaaaaaaaaaaaaaaaaaaaaaaaaaaaabaabbaaaaaaaaaaabaaaabaaaaaaababbaaaaaaaaaaaa
aaaaaaaaaaaaabbbbbbaaaaaaaaaaaaaaaaaaaaaaaaaaaaaaaaaaaababbaaaaaaaaaaaabaabaaaaaaaabaabaaaaaaaaaaaaa
aaaaaaaaaaaaabbbbbbaaaaaaaaaaaaaaaaaaaaaaaaaaaaaaaaaaabbbbaaaaaaaaaaaaabbbbbaaaaaaababbaaaaaaaaaaaaa
aaaaaaaaaaaaabbbbbbaaaaaaaaaaaaaaaaaaaaaaaaaaaaaaaaaaabbbbaaaaaaaaaaaaabbabaaaaaaaabbbbaaaaaaaaaaaaa
aaaaaaaaaaaaaabbbaaaaaaaaaaaaaaaaaaaaaaaaaaaaaaaaaaababbbaaaaaabbaaaaaaabbaaaaaaaaababbaaaaaaaaaaaaa
aaaaaaaaaaaaaabbbaaaaaaaaaaaaaaaaaaaaaaaaaaaaaaaaabbabbbbbaaabbbaaaaaaaaabbbaaaabbaaaaaaaaaaaaaaaaaa
aaaaaaaaaaaaaabbaaaaaaaabbbbbaaaaaaaaaaaaaaaaaaaabbbbbbbbaaabbaaaaaaaaaaabaabaabaaaaaaaaaaaaaaaaaaaa
aaaaaaaaaaaaaabbbaaaaaaabaaaaaabaaaaaaabababbbabbbabbabaaaaabaabaaaaaaaaabaaaabaaaaaabaaaaaaaaaaaaaa
aaaaaaaaaaaaabbbbbaaaaabaaabbaaabaaaabbaaaaaaaaabbbbaabaaaaababaaaaaaaaabaaaaabaaaabbaaaaaaaaaaaaaaa
aaaaaaaaaaaaabbbbbabbaababbbbbaaabbbbbbbbaaabbaaaaababbabbabababaaaaaaaabaabaababaaaaaaaaaaaaaaaaaaa
aaaaaaaabbaabbbbbbbbbbbbbbbbbbaaaabbbbbbbbaabbaaaabbbabaaaabbbaaaaaaaaabbaaaabaaaaaaaaaaaaaaaaaaaaaa
aaaaaaabbbabbbbbbbbbbbbbbbbbbbaaabbbbbbbabbabbaaaabbaaabaaabbabbbabbbbabaaaaaaaaaaaaaaaaaaaaaaaaaaaa
aaaaaaabbbbbbbbbbbbbbbbbbbbbbbabbbbbaaaabbbbbbaababaaaaabbbabbaabbbbbabaaaaaaaaaaaaaaaaaaaaaaaaaaaaa
aaaaaabbbbbbbbbbbbbbbbbbbbbbbbbaaaaaaaaaaaaaabaababaaaaaaaaaaaaaaaaaaaaaaaaaaaaaaaaaaaaaaaaaaaaaaaaa
aaaaabbbbbbbbbaaabbbbaaaaaaaaaaaaaaaaaaaaaaaabaabbaaaaaaaaaaaaaaaaaaaaaaaaaaaaaaaaaaaaaaaaaaaaaaaaaa
aaaaabbbbbbbbaaaaabbaaaaaaaaaaaaaaaaaaaaaaaaabbbbbaaaaaaaaaaaaaaaaaaaaaaaaaaaaaaaaaaaaaaaaaaaaaaaaaa
aaaaabbbbbbabaaaaaaaaaaaaaaaaaaaaaaaaaaaaaaabaabbabaaaaaaaaaaaaaaaaaaaaaaaaaaaaaaaaaaaaaaaaaaaaaaaaa
aaaaabbbbbbaaaaaaaaaaaaaaaaaaaaaaaaaaaaaaaaabbbabbbaaaaaaaaaaaaaaaaaaaaaaaaaaaaaaaaaaaaaaaaaaaaaaaaa
aaaaaabbbbbaaaaaaaaaaaaaaaaaaaaaaaaaaaaaaaaaaaaaaaaaaaaaaaaaaaaaaaaaaaaaaaaaaaaaaaaaaaaaaaaaaaaaaaaa
aaaaaaaabaaaaaaaaaaaaaaaaaaaaaaaaaaaaaaaaaaaaaaaaaaaaaaaaaaaaaaaaaaaaaaaaaaaaaaaaaaaaaaaaaaaaaaaaaaa
aaaaaaaaaaaaaaaaaaaaaaaaaaaaaaaaaaaaaaaaaaaaaaaaaaaaaaaaaaaaaaaaaaaaaaaaaaaaaaaaaaaaaaaaaaaaaaaaaaaa
aaaaaaaaaaaaaaaaaaaaaaaaaaaaaaaaaaaaaaaaaaaaaaaaaaaaaaaaaaaaaaaaaaaaaaaaaaaaaaaaaaaaaaaaaaaaaaaaaaaa
"}
