"a" = (/turf/liquid{tag = "icon-GreenWater1"; icon_state = "GreenWater1"},/area)
"b" = (/turf/liquid{tag = "icon-GreenWater2"; icon_state = "GreenWater2"},/area)
"c" = (/obj/Terrain/edge{tag = "icon-northShale"; icon_state = "northShale"},/turf/ground{tag = "icon-grassBlue"; icon_state = "grassBlue"},/area)
"d" = (/turf/ground{tag = "icon-grassBlue"; icon_state = "grassBlue"},/area)
"e" = (/obj/Terrain/edge{tag = "icon-northShale"; icon_state = "northShale"},/turf/wall/decWall{tag = "icon-Stone"; icon_state = "Stone"},/area)
"f" = (/turf/wall/decWall{tag = "icon-Stone"; icon_state = "Stone"},/area)
"g" = (/obj/Spawn{name = "Namek Spawn"; tag = "Namek"},/turf/ground{tag = "icon-grassBlue"; icon_state = "grassBlue"},/area)

(1,1,1) = {"
aaaabbbbbbbbbbbbbbbbbbabbbabbbbbbbabbbbbbbbbbbbbbbbbbbaabbbbbbbbbbbbbbbbbabbbbbbbbbbbaabbbbbbbbbbbbb
abaabbbbbbbbbbbbbbbaabbbabbbbbbbbabbbbbbbbbabbbbbbbbbaaabbbbbabbbbbaababbaabbbbbbbbbbababbbbbbbbbbbb
baaabbbbbbbbbaabbbaabababbbbbbbbbbbbbbbbbbaaabbaabbbbababbbbabbaabbaaaabaabbbbbbbbbbabababbbbbbbbbbb
babaaabaabbbabbbbbabbbabbbbbbbaaaabbbbbbbbaaaabbababababbbbbabaabbbaaaaaababbbabbbaaaaaaabbbabbbbbbb
bababbbabbbbaaaaaaabbabbbbabbabbaabbaaaaaaaaabbbbaabbbbbabaaaaaabbbaaabbbbabbbaabbabaaaaabaaaabbbbbb
baaabbbabaaaaabbbaabbabbbbaaabbbbaaaabbbbaabbbabaabbbbababaaaaabaabaaabaaababaaababbaaaaabaabaabbbbb
baabbbbbbbaaaabbabababbbaababaaaaaaabaabbaabbaaaaaaaaaaaaababaaabbaaabbabaaabaaabbbbaaaaaaaaaaababbb
bbabbaababbbabbbabaaaababaaaaaabaabbbbabbabbbabbaaababaaabaabbabbaabbbaaaaaaaaaaabbabaaabaaaaaaaaabb
bbabbbaabbbaabbbaaabaaaaabaaaababbaababbabbabbbbabaaabbabaaabbbbababbaaabaaaaaaabbaaaaaaaaaaaaaababb
bbbbaababbababbbaaaaababbaaaabbbbaaabbbbbabbaaaababaabbbbaabbbabaabbbaabaaaaaaaababbabbbaaaaaaaaabbb
bbaabaaaaabbaaaaaabbbbbbbaaaabaabbbbbbabbbabaababbababababbabaaababbabaaaaaabbabaabaabbaabaaaaaabbbb
bbbbaaaababbabbbbbbbabbbbabbaaaabbaaaaaabbaaabbbaababbabaabbabbbbaabbaaabaabbbaaaaaabbbabbaabaaabbbb
bbbbababbbbbabbaabbbbbbbbbaaaabbbbbabbbbbaabbbbaabbabbabbbbbbabbabbbbbbbbbbbbbaaaababbaabbabbaaabbbb
abbbaaababbbabbbbbbaabbbbbbbaabbbabbbbbbbabbbbababaabbbbbbbbbbbabbbbbbbbbbbbbbabbaaabbbbbbbbbabbbbbb
abbaabbaaaaabbabbababbbabbbbbabbbabbbbbbbbbaababbbaabbbbbaaabbbaaaaaaaabbbbbbbabaababbbbbbbbabbbbbbb
abbaaabbabbabaabbaaabbaabbbabbbbababbbbbbbbaababbaaabbbbaababbaabbbbbbaaaaaaabaabbabbbbbbaababbbbbbb
aaaabbabaaabbabbaababbaabbbabbbbababaabbbbaabbaaabbbbaaabbbaababaaaaaaaabbbbbaaabbacccbbaaababbbbbbb
bbaaabaaababaaabbaabbbaabbabbbaaaaaaaabbbaabbaaabbabaaabaababaaaaaabbbabbbbbaacccccdddcccababbbbbbbb
bbbbaabaaaaaaabbbbabbbbabaabbaabaaaaaaabaabccccccccccaaabbbababaaaabbaabbbbbacdddddddddddcaaaabbbbbb
bbbaaaaaaaabbabbbbabbbbbaabbaabaaaaaabaaabcddddddddddccbbbaaaaaaababababbbcccdddddddddddddccbaabbbbb
bbaaababaaabbbbaababbbabaababaaaaaaabbbbacdddddddddddddcccaaaaabaaaaacccccddddddddddddddddddbbabbbbb
bbaaaabbaaaaaaabbbbaabbababaaaaabaaabbbaadddddddddddddddddcccccccccccdddddddddddddddddddddddbbabbbbb
baaabaabaabbbaabbbbbabaaaaabbbaabaababbbbdddddddddddddddddddddddddddddddddddddddddddddddddddbbabbbbb
aabbbabaaabababbbbbbaaabaabbbbababbaaabccdddddddddddddddddddddddddddddddddddddddddddddddddddababbbbb
abbbbbabbbbbabbbbbbaaabbbabbbabbbbbbcccdddddddddddddddddddddddddddddddddddddddddddddddddddddabababbb
bbaababbbbabaabbbbaaaabbaabbabccccccddddddddddddddddddddddddddddddddddddddddddddddddddddddddcaababbb
bbaaaaabbaabaabbbbabbbbbbaaaacdddddddddddddddddddddddddddddddddddddddddddddddddddddddddddddddbaaabbb
bbaaaabbbbbbbbbbbaaababbbbaccddddddddddddddddddddddddddddddddddddddddddddddddddddddddddddddddbabbbbb
bbaabbbbbabbbabbbaabbabbbbcddddddddddddddddddddddddddddddddddddddddddddddddddddddddddddddddddbaaabbb
bbaaaabaabbabbbbbbbbbbaabbdddddddddddddddddddddddddddddddddddddddddddddddddddddddddddddddddddbbababb
bbabbbaabbaabbabaabbbaaabadddddddddddddddddddddddddddddddddddddddddddddddddddddddddddddddddddaaaaabb
bbaabbbbabbbbbbababbbbabbcdddddddddddddddddddddddddddddddddddddddddddddddddddddddddddddddddddaaaaabb
bbabbbabbbbbabbbaaabbbaabddddddddddddddddddddddddddddddddddddddddddddddddddddddddddddddddddddaaaaabb
bbbbbabbbbbbbbbaaabbbbbbbddddddddddddddddddddddddddddddddddddddddddddddddddddddddddddddddddddbaaaabb
bbbaaabbbbbaaaaabbabbbaccddddddddddddddddddddddddddddddddddddddddddddddddddddddddddddddddddddbaaaabb
bbbabaabbbaaabaaababcccddddddddddddddddddddddddddddddddddddddddddddddddddddddddddddddddddddddaababbb
bbaabababbaacccccbccdddddddddddddddddddddddddddddddddddddddddddddddddddddddddddddddddddddddddabaabbb
bbaabbabbaacdddddcdddddddddddddddddddddddddddddddddddddddddddddddddddddddddddddddddddddddddddaaabbbb
bababbbaaaaddddddddddddddddddddddddddddddddddddddddddddddddddddddddddddddddddddddddddddddddddaabbbbb
bababbbaaaaddddddddddddddddddddddddddddddddddddddddddddddddddddddddddddddddddddddddddddddddddabbbbbb
aabababaabbedddddddddddddddddddddddddddddddddddddddddddddddddddddddddddddddddddddddddddddddddabbbbbb
abaaabbbbbbfdddddddddddddddddddddddddddddddddddddddddddddddddddddddddddddddddddddddddddddddddabbbbbb
bbabbbbbbbafdddddddddddddddddddddddddddddddddddddddddddddddddddddddddddddddddddddddddddddddddaabbbbb
bbabbbbabbbfeddddddddddddddddddddddddddddddddddddddddddddddddddddddddddddddddddddddddddddddddaaabbbb
bbbbbbbbbabffedddddddddddddddddddddddddddddddddddddddddddddddddddddddddddddddddddddddddddddddaaabbbb
bbbbbbbabbbbffeedddddddddddddddddddddddddddddddddddddddddddddddddddddddddddddddddddddddddddddaaabbbb
bbbbbbbaabbbffffeddddddddddddddddddddddddddddddddddddddddddddddddddddddddddddddddddddddddddddaaabbbb
bbababbbbbabbbbffeeddddddddddddddddddddddddddddddddddddddddddddddddddddddddddddddddddddddddddbaabbbb
bbabbbbabbbbabbafffdddddddddddddddddddddddddddddddddddddddddddddddddddddddddddddddddddddddddebabbbbb
bbbbbbbabababbaabffeddddddddddddddddddddddddddddddddddddddddddddddddddddddddddddddddddddddddcbabbbbb
bbaabbbaaabbbabaaaffeddddddddddddddddddddddddddddddddddddddddddddddddddddddddddddddddddddddddbabbbbb
bbaaaabbaaaaaabbabbffeddddddddddddddddddddddddddddddddddddddddddddddddddddddddddddddddddddddebabbbbb
baabbbbbabbbbabbbbaaffedddddddddddddddddddddddddddddddddddddddddddddddddddddddddddddddddddddfaabbbbb
baabbbbaababbaaaababbffedddddddddddddddddddddddddddddddddddddddddddddddddddddddddddddddddddefbabbbbb
bbabbbbbbbbbaaabbaababffdddddddddddddddddddddddddddddddddddddddddddddddddddddddeeddddddddddffbabbbbb
bbaabbbbbbaabbbbbbaabaafdddddddddddddddddddddddddddddddddddddddddddddddddddddeeffeeeddddddefbbabbbbb
babbbbbbbbaabbbbbaaabaacdddddddddddddddddddddddddddddddddddddddddddddddddddeefffffffeedddeffbabbbbbb
bbbbbabbbbabbbbbbababbcdddddddddddddddddddddddddddddddddddddddddddddddddddefffaabbbfffeeeffabbbbbbbb
ababaabbbaabbbbbbababcdddddddddddddddddddddddddddddddddddddddddddddddddddeffbaaabbbaafffffaabbbbbbbb
aabbbabbababcccccccccdddddddddddddddddddddddddddddddddddddddddddddddddddeffbbaaabbbaaaaabbaabbbbbbbb
bbbbababbaacdddddddddddddddddddddddddddddddddddddddddddddddddddddddddddeffbbaaababbabbbbbbaabbbbbbbb
bbbbbabbcccddddddddddddddddddddddddddddddddddddddddddddddddddddddddddddffbbaaabaabbbbbbbbaaababbbbbb
bbbbaabcdddddddddddddddddddddddddddddddddddddddddddddddddddddddddddddddbbbbbaaaabbaabbbbbabaaabbbbbb
bbbababddddddddddddddddddddddddddddddddddddddddddddddddddddddddddddddddbbbbabaaabababbbbbaabaabbbbbb
bbbabbcddddddddddddddddddddddddddddddddddddddddddddddddddddddddddddddddbbbbabaaaabaaabbbbbabaabbbbbb
bbababdddddgdddddddddddddddddddddddddddddddddddddddddddddddddddddddddddbbbbbaaaaaaabbbbbbbaaaabbbbbb
bbababdddddddddddddddddddddddddddddddddddddddddddddddddddddddddddddddddbbbbbaaaaabbbbbbabbbababbbbbb
babbabdddddddddddddddddddddddddddddddddddddddddddddddddddddddddddddddddbbbbaababbbbbaaaabbbababbbbbb
abbbabdddddddddddddddddddddddddddddddddddddddddddddddddddddddddddddddddbbbbaaaabbbaaaababbbabbbababb
ababaaeddddddddddddddddddddddddddddddddddddddddddddddddddddddddddddddddbbbbbbbaaaababaaaabbabbaaaabb
bbaaabfddddddddddddddddddddddddddddddddddddddddddddddddddddddddddddddddcbbbbbaabbbaaaaaabaaababaaabb
baaaabfeddddddddddddddddddddddddddddddddddddddddddddddddddddddddddddddddbbbbaaaabaabaababbbbabbaabbb
bbaaabffddddddddddddddddddddddddddddddddddddddddddddddddddddddddddddddddcbbbaaaabaaabaaabbbbabaabbbb
bbaaabbfeddddddddddddddddddddddddddddddddddddddddddddddddddddddddddddddddbbaaaaaabaabaaabbbbabaabbbb
abaaabbffddddddddddddddddddddddddddddddddddddddddddddddddddddddddddddddddbabababbbbabababbbabbaabbbb
aabbbbbafdddddddddddddddddeeeddddddddddddddddddddddddddddddddddddddddddddcaabaabbbbbbaabbbaaaababbbb
abbbbabbfedddddddddddddddefffeeeeeeeddddddddddddddddddddddddddddddddddddddbaabaaabbbbaabbaabbababbbb
bbbbabbbffdddddddddddddddfffffffffffeeddddddddddddddddddddddddddddddddddddabbababaabbbaaabbbbbbabbbb
bbbaaababfdddddddddddddddfabbbbbbbbfffedddddddddddddddddddddddddddddddddddaaaabbaaabbbbabbbbbbbbbbbb
bbbbababafedddddddddddddefbbbbbbbbaaaffeddddddddddddddddddddddddddddddddddabaaaabbbbbaaabaaabbabbbbb
bbbabbbbbffeddddddddddddffbbbbbbbabbabffedddddddddddddddddddddddddddddddddaaaabbbbbbbabaabbbbbabbbbb
baabaaaabbffdddddddddddefbaabbbbaaaaabbffeddddddddddddddddddddddddddddddeebbaabbbbbbaabbbbbabbabbbbb
bbaaaaaaabafedddddddeeeffbababaaaabababbffdddddddddddddddddddddddddddddeffbbaabbbbbabbbbbbbabbabbbbb
bbaaaaaaaabffdddddeeffffbabaaaaabbabbaabbfddddddddddddddddddddddddddddeffbbbaaaabbaaababbbbbababbbbb
bbaaaabbaabbfeeeeefffffabaaaabaababbbbabafeddddddddddddddddddddddddddeffaaaaabbbaaabbaabbbbbababbbbb
bbaabbbaaabbfffffffaabaabaaabbaababbbbaabffdddddddddddddddddddddddddeffaaaaaabbbabbaaabbbaabbabbbbbb
baaababbababbabbbaabbbabbaaaababaabbbbaaabfeeddddddddddddddddddddddeffabaabaabbbbbabababbaaaababbbbb
babaabbbbbbaabbbaabbbbaaabbaabbaabbaabbbbafffdddddddddddddddddddddeffbbbbaaaabbbbbabbabbbabaababbbbb
aabbabbbbabbbbbbaabbbbabbbbbaaabbbbabaaababffeeddddddddddddddddddeffbbbbbbbabbbbbbbaaaabbbaababbbbbb
aabaaabbaabbaabaabbbbaabbbbbbbbabaaaaabbbbaffffeeddddddddddddddddffbbbbbbbaabbbbbaaaaaabababbbbbbbbb
aabaaababbbbbababbbbaabbbbbabbbabbbaabababbaaffffeeeeeeeddddddeeefbbbbbbbbaabbbbbaaabaabaaaabbaabbbb
aabbaaababbbbaaaabbabbbbbbabbbbabbababababaabbbfffffffffeeeeeeffffabbbbbbababbbbaaaaabaaaaaabbaabbbb
abbbabbbbbbbbababbbbbbbbbbbbbbbababbabbabbbbbbbaaaaaaaaffffffffbaaaaabbbbaaabbbaaaaaabbbabaababbabbb
abbabababbbbabaabbbbabbbbabbabbbaabaaaaababbbbbbbbababbbbbbbbaaaaaaabbbbbbbabbbaaaaabbbbaaababbbbbbb
abbabbabbbbabaabbbbbbbbbabbbbaabaaaaaaaaabbbbbbbbbababbbbbbbbaabaaabbbbbabbaababbaabbbbbaaaaabbaaabb
abbbabbbbbbbbaabbabbbaaabbbbbaaaaaaabaaaaabbbbbbabaaaaaaaaaaaabaaaaaaaaaabbbabaaaabbbbbbbbaabbaaabbb
bbbabbabbbabbaabbbabbbbbbbbbbbbbaaaaabbabbaaaaaabbbaababaabbababbbbbbbbabbbbaababbbbabbbbbbbaabbabbb
bbabbbbababbbbbbbbbbbbbbbbbbbbbbaabbbbbabbbbbbbbbbbbaabbbaabaabbbbbbbbbbbbbbaaababaaabbbbbabbbbaabbb
bbabbbbbabbbbbbbbbbbbbbbbbbbbbbbbbbbbbbbbbbbbbbbbbbbbbbbbbaaaabbbbbbbbbbbbbbaabbbbbbabbababbbbbaabbb
bbbbbbbbbbbbbbbbbbbbbbbbbbbbbbbbbbbbbbbbbbbbbbbbbbbbbbbbbbbbbbbbbbbbbbbbbbbbbbbbbbbbaaaaabbbbbaaabbb
"}
