"a" = (/turf/liquid/water{tag = "icon-Water1"; icon_state = "Water1"},/area)
"b" = (/turf/liquid/water{tag = "icon-Water2"; icon_state = "Water2"},/area)
"c" = (/turf/ground/sand{tag = "icon-sand3"; icon_state = "sand3"},/area)
"d" = (/turf/ground/sand{tag = "icon-sand2"; icon_state = "sand2"},/area)
"e" = (/turf/ground/sand{tag = "icon-sand1"; icon_state = "sand1"},/area)
"f" = (/obj/testSaveObj,/turf/ground/sand{tag = "icon-sand1"; icon_state = "sand1"},/area)
"g" = (/obj/Terrain/edge{tag = "icon-Shale (NORTH)"; icon_state = "Shale"; dir = 1},/obj/Terrain/edge{tag = "icon-Shale (WEST)"; icon_state = "Shale"; dir = 8},/obj/Terrain/edge{tag = "icon-Shale (EAST)"; icon_state = "Shale"; dir = 4},/turf/ground/fertile/grass{tag = "icon-grass1"; icon_state = "grass1"},/area)
"h" = (/obj/Terrain/edge{tag = "icon-Shale (NORTH)"; icon_state = "Shale"; dir = 1},/obj/Terrain/edge{tag = "icon-Shale (WEST)"; icon_state = "Shale"; dir = 8},/turf/ground/fertile/grass{tag = "icon-grass1"; icon_state = "grass1"},/area)
"i" = (/obj/Terrain/edge{tag = "icon-Shale (NORTH)"; icon_state = "Shale"; dir = 1},/turf/ground/fertile/grass{tag = "icon-grass1"; icon_state = "grass1"},/area)
"j" = (/obj/Terrain/edge{tag = "icon-Shale (NORTH)"; icon_state = "Shale"; dir = 1},/obj/Terrain/edge{tag = "icon-Shale (EAST)"; icon_state = "Shale"; dir = 4},/turf/ground/fertile/grass{tag = "icon-grass1"; icon_state = "grass1"},/area)
"k" = (/obj/Terrain/edge{tag = "icon-Shale (WEST)"; icon_state = "Shale"; dir = 8},/turf/ground/fertile/grass{tag = "icon-grass1"; icon_state = "grass1"},/area)
"l" = (/turf/ground/fertile/grass{tag = "icon-grass1"; icon_state = "grass1"},/area)
"m" = (/obj/Terrain/edge{tag = "icon-Shale (EAST)"; icon_state = "Shale"; dir = 4},/turf/ground/fertile/grass{tag = "icon-grass1"; icon_state = "grass1"},/area)
"n" = (/obj/testSaveObj,/turf/ground/fertile/grass{tag = "icon-grass1"; icon_state = "grass1"},/area)
"o" = (/obj/testSaveObj,/turf/ground/sand{tag = "icon-sand3"; icon_state = "sand3"},/area)
"p" = (/turf/wall/decWall{tag = "icon-Shale"; icon_state = "Shale"},/area)
"q" = (/obj/Terrain/edge{tag = "icon-Shale (WEST)"; icon_state = "Shale"; dir = 8},/obj/Terrain/edge{tag = "icon-Shale (EAST)"; icon_state = "Shale"; dir = 4},/turf/ground/fertile/grass{tag = "icon-grass1"; icon_state = "grass1"},/area)
"r" = (/obj/Terrain/edge{tag = "icon-Shale (WEST)"; icon_state = "Shale"; dir = 8},/obj/Terrain/edge{tag = "icon-Shale (NORTH)"; icon_state = "Shale"; dir = 1},/turf/ground/fertile/grass{tag = "icon-grass1"; icon_state = "grass1"},/area)
"s" = (/turf/ground{tag = "icon-grass1"; icon_state = "grass1"},/area)
"t" = (/turf/ground/sand,/area)
"u" = (/light_obj/Campfire,/turf/ground/sand{tag = "icon-sand3"; icon_state = "sand3"},/area)

(1,1,1) = {"
aaaaaaaaaaaaabbaaaaaaaaaaaaaaaaaaaaaaaaabaaaabaaaaaaaaaaaabbbaaaaaaaaaaaaaaaaabbaaaaaaaaaaaaaaaaaaaa
aaaaaaaaaaaaababaaaaaaaaaaaaaaaaaaaaaaaabaaaaaaaaaaaaaaaabbbbaaaaaaaaaaaaaaaababaaaaaaaaaaaaaaaaaaaa
aabbbaaaaaabaaabaaaaaaaaaaaaaaaaaaaaaaabaaaaaabaaaaabbbbbbaaaaaaaaaaaaaaaaaaabbbbaaaaaaaaaaaaaaaaaaa
aabbbaaaaaabaaabbbbaaaaaaaaaaaaaabbbbaabaaaaabaaabbbbbbbaaaaabbaaabbaaaaaaaaabbaabaaaaaaaaaaaaaaaaaa
aabbbaaaaaabbbbbaabaaaaaaabbbabbbbbbbaabaaaabaaaabbabbbaabbbbbbbbbaaaaaaaaaabbbaabbaaaaaaaaaaaaaaaaa
aabbbaaaaabbabbaaabaaaaaabaaaaaabbbbabbaaaaaaaaaaaaabbbbbaaaaabbaaaaaaaaaaaabbbaabbaaaaaaaaaaaaaaaaa
aaaabaaaababbbaaabbaaaaaaaaaaaabbaabbabaaaabaaaaaaaaaabaaaaaaaaaaaaaaaaacaababaaabbaaaaabbbbbbaaaaaa
aababaaaaaabbbaabaaaaaaaabaaaaabbabbaaabbbbaaaaaaaaaaabaaaaaaaaaaaaaaaccccababbbbbbbbbbbbbbbaabaaaaa
aababbaaabbbbbbbbaaaaaaabaaaaaabaabbaaaaaaaaaaaaaaaaaabbaaaaaaaaaaaaacccccabbabbbaaaaaabababbbbaaaaa
aaababaaabbbbbbaabaaaaaabaaaaaababbabaaaaaaaaaaaaaaaabbbbbbaaaaaaaaacccccccaaaaaaaaaaabaababbbaaaaaa
aaaaabaaabbbaaabbbbaaabbaaaaaaababbbbaaaaabbaaaaaaaabbaaabbbaaaaaacccccdccccaaaaaaaaaabaababbbaaaaaa
aaaaabbbbbbbaaaaaaabbbaaaaaaaaabbabbaaaaababaaaaaaabbaaaababaaaaaacccecdeeccaaaaaaaaaabaababbaaaaaaa
aaaaaaaaaaaaaaaaaaaaaaaaaaaaaaaabbbbaaaaababaaaaaabbbaaabbbbaaaaaacceeddeeeccaaaaaaaaaabababbaaaaaaa
aaaaaaaaaaaaaaaaaaaaaaaaaaaaaaaaabaaaaabbaaaaaaaaaaabaabbabbaaaaaaaceeddefeccaabbbbabbbbaabaaaaaaaaa
aaaaaaaaaaaaaaaaaaaaaaaaaaaaaaaaabababaaaaabaaaaaaaabbbaaabaaaaaaaaceeddeeecccbaaabbbaaaaaaaaaaaaaaa
aaaaaaaaaaaaaaaaaaaaaaaaaaaaaaaabbbaaaaaaabbaaaaaaaaaaaaaaaaaaaaaaaceccdeeeeccbaabaabaaaabbaabbaaaaa
aaaaaaaaaaabbaaaabbbbbaabbbbbabbabaaaaaaaabaaaaaaaaaaaaaaaaaaaaaaaccccdcdeeecccaabbbbaaaaabbbbbbaaaa
aaaaaaaaaabbbbbbbbbabbbbbbbbaaaaaaabaaaaabbaaaaaaaaaaaaaaaaaaaaaaaeecededceeeccabbabbbaaaabbbbbbaaaa
aaaaaaaaaabbbabbaaaaaaaabbbbaaaaaaaabaaabbaaaaaaaaaaaaaaaaaaaaaaaceccddcceceeccababbbbbbbbabaaabbaaa
aaaaaaaaababbbbbaaaaaaaaabbbbaaaaaaaababaaaaaaaaaaabaaaaaaaaaaaaccedddceeccceccabbbaababaabbaaabbbaa
bbbaaaabbbbbbaaabbbbbabbbababaaaaaaaaaaaaaaaaabaabbbaaaaaaaaccccedddcceceeeeeccabbaaababaabbaaabbbaa
baababbbbbbbbbabbbaaaaaaabbbbaaaaaaaaaaaaaaaabbababbaaaaaaaacddddececccceeccccgabbaabaabaabbabbaabba
baabbababbaaababaaaaaaaaaaabbaaaaaaaaaaaaaabbbbbaabaaaaaaaahiiiiijegcccceccccckjabbbaaabaabbbabbaaaa
babbaabbbbaaaabbaaaaaaaaaaaaaaaaaaaaabbaaababbaaabbaaaaaaahlllllllililliccccchlmaaaabbbaababbbabaaaa
bbbaabbabbaaaaaabbaaaaaaaaaaaaaaaaaabbaabbabbaaaabaaaaaaahllllllllllllllijcchllmaaaaaaaabaabbbbaaaaa
bbabbababbaaaaababaaaaaaaaaaaaaaaaabbbabaabbaaaaaaaaaaaahllllllllllllllllliilllljaaaaaaabaaaaaaaaaaa
abbaaabaabaaaabaabaaaaaaaaaaaaaaaaabbbaaaaaaaaaaaaaaaaaaklllllllllllllllllllllllljaaaaaabaaaaaaaaaaa
aaaaaabaaaaaacccccccaaaaaaaaaaaabaaaaaaaaaaaaaaaaaaaaaahlllllllllllllllllllllllllljaaaababbbaaaaaaaa
aaaaaabaaaaaccccccccaaaaaaaaaaaabaaaaaaaaaaabbaaaaaaaaaklllllllllllllllnllllllllllljaaaabaabbaaaaaaa
aaaaaabbaaaaccdcccccaaaaaaaaabaabaaaaaaaaaaabbaabaaaaahllllllllllllllllllllllllllllmaaabbbabaaaaaaaa
aaabbabbaaaaccdocccccaaaaaaaabbabaaaaaabbabbbbaaabaaahllllllllllllllllllllllllllllmpbbbaabaabbaaaaaa
aaabbbbbbaaacdcedcccccaaaaaaaababaaaabbbbbbbbaaababhillllllllllllllllllllllllllllmppaabaaababaaaaaaa
aabababbbabbcdceedceeccaaaaaaaaabbabbbbbbbbbbaaaaabklllllllllllllllllllllllllllllmpaaabaaaabbaaaaaaa
aababaabbbaacdcceeeeccccaaaaaaaaaababbaababbaaaababklllllllllllllllllllllllllllllmbbaabbaaaabaaaaaaa
aabbaabbbaaagcdddcdcddcccaaaaaaaaaaaaaaabbbbaaaaabbpklllllllllllllnllllllllllllllmbabbbbbbaabaaaaaaa
aabbababbaabqccccccccdddccccaaaaaaabaaaaabbbaaaaabbppklllllllllllllllllllllllllllljabbabbababaaaaaaa
aabbbaabaabakiijcchjcccdddccccaabbbbbaaaaabbaaaaaabbpkllllllllllllllllllllllllllllljbbbabbbbbaaaaaaa
aaaaaaaaaabakllllllliijccdcccccbbbbbabaaaaaaaaaabbaahllllllllllllllllllllllllllllllljaaaaaabbaaaaaaa
aaaabbbaabaapkllllllllljceeeccccccbbbabaaaaaaaaabahillllllllllllllllllllllllllllllllmaaaaaaabbaaaaaa
aaabbabaabaappklllllllllijcdeccccccccccccccchiiiiillllllllllllllllllllllllllllllllllmbbbbbaaaabaaaaa
aaabbbbbbbaaapppkllllllllljddecccccccccccccckllllllllllllllllllllllllllllllllllllllmpaaaabaaaabaaaaa
aaabbabbaaaaabpppkllllllllmccceeeeeeecccccchlllllllllllllllllllllllllllllllllllllllmpaaaabbbbbabaaaa
aababbbaaabbbbaappklllllllljcccccccceeeecchllllllllllllllllllllllllllllllllllllllllmaaaabbaaaabaaaaa
aababbbbbbbaabaaapkllllllllliiiijcccccccchllllllllllllllllllllllllllllllllllllllllmpaaaaaaaababaaaaa
aabbaabaaaaaabaaaakllllllllllllllijcccccckllllllllllllllllllllllllllllllllllllllllmpaaaaaabaabbaaaaa
aaaaaaaabbaaabaahillllllllllllllllliiiiiillllllllllllllllllllllllllllllllllnlllllmpaaaaaaabbbbaaaaaa
aaaaaaabbbaaaabakllllllllllllllllllllllllllllllllllllllllllllllllllllllllllllllllmpbaaaaaaaaaaaaaaaa
aaaaaabbbaaaaabhlllllllllllllllllllllllllllllllllllllllllllllllllllllllllllllllllmbbaaaaaaaaaaaaaaaa
aaaaabbabaaaaabklllllllllnllllllllllllllllllllllllllllllllllllllllllllllllllllllmpbbaaaaaaaaaaaaaaaa
aaaabbbbbbbbbahllllllllllllllllllllllllllllllllllllllllllllllllllllllllllllllllmppbbbaaaaaaaaaaaaaaa
aaaabbbbbaaaabkllllllllllllllllllllllllllllllllllllllllllllllllllllllllllllllmpppabbbabaaaaabbaaaaaa
aaabbbbabbaaaakllllllllllllllllllllllllllllllllllllllllllllllllllllllllllllllmppaaaaaabaaaabbaaaaaaa
aabaabbbbabaaaklllllllllllllllllllllllllllllllllllllllllllllllllllllpppklllllmaaaaaaaabaaabbaaaaaaaa
aababbaaabbaailllllllllllllllllllllllllllllllllllllllllllllllllllllppppppklllmaaaaaaaabaabbbaaaaaaaa
abaabaaaabbbillllllllllllllllllllllllllllllllllllllllllllllllllllppppppppelmppaaaaaaaababbbaaaaaaaaa
abaaaaaabbbhllllllllllllllllllllllllllllllllllllllllllllllllmppppppppccppeppppaaaaaaaabbbbaaaaaaaaaa
aabaaaabaabkllllllllllllllllllllllllllllllllllllllllllllllllmpppppppcccdddpppaaaaaaaaabbbaaaaaaaaaaa
aaabaaabaaakllllllllllllllllllllllllllllllllllllllllllllllllmccccccccccdaaaaaaaaaaaaaaaabaaaaaaaaaaa
aaaabbbaaaakllllllllllllllllllllllllllllllllllllllllllllllllmccccccccccaaaaaaaaaaaaaaaabaaaaaaaaaaaa
aaaaaaaaaaakllllllllllllllllllllllllllllllllllllllllllllllllmcccccccccaaaaaaaaaaaaaaaaabaaabbaaaaaaa
aaaabaaaaabkllllllllllllllllllllllllllllllllllllllllllllllllmaccccccaaaaaaaaaaaaaaaaaaabbbbbbaaaaaaa
aaabbaaabbakllllllllllllllllllllllllllllllllllllllllllllllllmaaaaaaaaaaaaaaaaaaaaaaaaabbaaabaaabaaaa
aaabbaaabaakllllllllllllllllllllllllllllllllllllllllllllllllmaaaaaaaaaaaaaaaabbaaaaabbbbaabbaabaaaaa
aaabbaabaaakllllllllllllllllllllllllllllllllllllllllllllllllmaaaaaaaaaaaaaaabbaaaaabababaabaabbaaaaa
aaabbaabaahlllllllllllllllllllllllllllllllllllllllllllllllllmaaaaaaaaaaaaaabbaaaaabbbababbaaabaaaaaa
aaabaaabahlllllllllllllllllllllllllllllllllllllllllllnllllllmaaaaaabaaaaaabbaaaabbabaababbaabaaaaaaa
aaabbbahillllllllllllllllllllllllllnllllllllllllllllllllllllmaaaaaabaaaabbbaaaaabaabaabbababbabbaaaa
aaabaaakllllllllllllllllllllllllllllllllllllllllllllllllllllmaaaaaabaaabbbbaaaaaaabaaabbbabaaabaaaaa
aabbbbhlllllllllllllllllllllllllllllllllllllllllllllllllllllmaaaaabaaabbbbaaaaaaabbaabbbabaaaabaaaaa
aabbabklllllllllllllllllllllllllllllllllllllllllllllllllllllmaaaabbaabbbbaaaaaaaabbbbabaabbaabbaaaaa
aabaarlllllllllllllllllllllllllllllllllllllllllllllllllllllmpaaaababbbbbaaaaaaaaaabaabbbbbbaaabbaaaa
aabaaklllllnllllllllllllllllllllllllllllllllllllllllllllllmppaaaabbaabaaaaabaaaaabaaabbaaabaaabaaaba
aaaaakllllllllllllllllllllllllllllllllllllllllllllllllllllmpaaaaaaaaaaaaaaabaaaabaaaaaaaaabaabaaaaab
aaaaaklllllllllllllllllllllllllllllllllllllllllllllllllllmpaaaaaaaaaaaaaaabaaaabaaaaaaaaaabaabaaaaaa
aaaaakllllllllllllllllllllllllllllllllllllllllllllllllllmppaaaaaaaaaaaaaaabaabbbaaaaaaaaaabaabaaaaaa
aaaaaplllllllllppplllllllllllllllllllllllllpppklllllllllmpaaaaaaaaaaaaaaaabbbbbaaaaaaaaaaabaabaaaaaa
aaaabppppllllppppppllllsssllllllllllllllllpppppklllllllmpaaaaaabaaaaaaaaabbbbbbaaaaabaaabbbbbbaaaaaa
aaabbbppppllppppppplllssssslllppppppppppppppppppppklllmppaaaaabbaaaaaaaaaaabbabbbbbbbabaaabbbaaaaaaa
aaabbbbbpppppppccppplssssssslpppppppppppppppcppppppkppppaaaaabbaaaaaaaaaaaabaaaabaababaabbbbbaaaaaaa
aabaabbbbppppddcccppppppepppppppccccccppppccccccccpppppaaaaaabaabbaaaaaaaaaaaaaabbababbbbbbbbaaaaaaa
aabbbaabbbbddddccccpppppeppppppcddccccccccccccccccpppaaaaaaabbbbbbaaaaaaaaaaababbabbbabbabbabaaaaaaa
abbaaaabaaaabaaceccccccctcccccccdddedddcccceecccaaaaaaaaaaaaaaaabbaaaaaaaaaabbbaaaaaababbaaabaaaaaaa
bbbbbabbaaaabaaaceecccocccttcceccdcccceddcceeccaaaaaaaaaaaaaaaaabaaaaaaaabbbbaaaaaabbabbaaaabaaaaaaa
aaaababaaaaaabaaaceeettttttccecddccaacccecceccaaaaaaaaaaaaaaaaabaaaaaaaabbbbaaaaaabbbbaaaaaabaaaaaaa
aaaababaaaaaabaaaaccceeeeucceddcaaaaaacccececcaaaaaaaaaaaaaaaaabbbbbbabbbbbbaaaaaabbaaaaaaabaaaaaaab
aaaabbaaaaaaabaaaaccccceccceeccaaaaaaaaacceeccaaaaaaaaaaaaaaaaaaaaaaaaaaabbaaaaaaaabaaaaaabbaaaabbba
aaaabbaaaaaaaabaabbbcccceceeeccaaaaaaaaaacccccaaaaaaaaaaaaaaaaaaaaaaababbbaaaaaaaaaababbbbbbaaabaaaa
aaaabaaaaaaaaabbbaaaaacceeccccaaaaaaaaaaacccccaaaaaaaaaaaaabbbabbabbbbbbaaaaaaaaaaaabbbbabbaaabaaaaa
aaabaaaaaaaaaaaaaaaaaaccccccccaaaaaaaaaaacccccaaaaaaaaaabbbbbbbbbbaaaaaaaaaaaaaaabbbbbabbbaaabaaaaaa
aaabaaaaaaaaaaaaaaaaaaaccccccaaaaaaaaaaaaacccaaaaaaaaaabaaaaaaaaaaaaaaaaaaaaaaaabbbbaabbbababaaaaaaa
aabbaaaaaaaaabaaaaaaaaaaaaaaaaaaaaaaaaaaaaaaaaaaaaaaaabaaaaaaaaaaaaaaaaaaaaaaaaabbbaaabbbbaaaaaaaaaa
aabbaaaaabbbbbaaaaaaaaaaaaaaaaaaaaaaaaaaaaaaaaaaaaaaabaaaaaaaabbbbbbbaaaaaabbaababaaabbbaaaaaaaaaaaa
abaabbbbbaaabaaabaaaaaaaaaaaaaaaaaaaaaaaaaaaaaaaaaaabaaaaaabbbbaaaaabbabbbaabbaabbaaabaaaaaaaaaaaaaa
baabbaaaaaabbabbbaaaaaaaaaaaaaaaaaaaaaaaabbbbbaaabbbaaaaabbbbaaabbabbabbbbbbbaabaaaabaaaaaaaaaaaaaaa
bbbabaaaaabbbbaabaaaabbbaaaaaaaaaaaabbbabaaabbabbbbaaaaaaabbbbbaaabbaaaaaaabaabbaaaabbbbbbbbaaaaaaaa
baaabbaaabbbbaaabbbbbaaaaaabaaaaaaaabbbbbbbbbbbbababbbbaaaaaaaabbabbbbaaaabbbbaaaaabbbbababaaaaaaaaa
aaaaabbbbbbbaabbbbabbabbabbbbaaaaaaabbaaaabbbbbbbbaabbbbbaaabbbbbbaaabbaababbabbbbbabbabbbbaaaaaaaaa
aaaaaaabbbbbbbbbabbabbbbbbbaaaaaaabbbaaaaaaaaaabbabbbbbaabababbbbaaaababbbbbbbaaaaabbababbaaaaaaaaaa
aaaaaaabbaaaaaaaabaaabbbaabbbbbbbbaaaaaaaaaaaababbbabbbbbaaaaaaaaaaaabaaabbaaaaaabbbbbababaaaaaaaaaa
aaaaaaaaaaaaaaaaabbbbaaaaaaaaabbaaaaaaaaaaabbbbbbaaaaaaaaaaaaaaaaaaaaaaabbaaaaaabbbbbbbbbbaaaaaaaaaa
"}
