"a" = (/turf/liquid/water{tag = "icon-Water1"; icon_state = "Water1"},/area)
"b" = (/turf/liquid/water{tag = "icon-Water2"; icon_state = "Water2"},/area)
"d" = (/turf/ground/sand{tag = "icon-sand2"; icon_state = "sand2"},/area)
"e" = (/turf/ground/sand{tag = "icon-sand1"; icon_state = "sand1"},/area)
"m" = (/turf/wall/decWall{tag = "icon-Shale"; icon_state = "Shale"},/area)
"o" = (/turf/ground/fertile/grass{tag = "icon-grass1"; icon_state = "grass1"},/area)
"p" = (/turf/ground{tag = "icon-grass1"; icon_state = "grass1"},/area)
"q" = (/turf/ground/sand,/area)
"r" = (/turf/ground/sand{tag = "icon-sand3"; icon_state = "sand3"},/area)

(1,1,1) = {"
aaaaaaaaaaaaabbaaaaaaaaaaaaaaaaaaaaaaaaabaaaabaaaaaaaaaaaabbbaaaaaaaaaaaaaaaaabbaaaaaaaaaaaaaaaaaaaa
aaaaaaaaaaaaababaaaaaaaaaaaaaaaaaaaaaaaabaaaaaaaaaaaaaaaabbbbaaaaaaaaaaaaaaaababaaaaaaaaaaaaaaaaaaaa
aabbbaaaaaabaaabaaaaaaaaaaaaaaaaaaaaaaabaaaaaabaaaaabbbbbbaaaaaaaaaaaaaaaaaaabbbbaaaaaaaaaaaaaaaaaaa
aabbbaaaaaabaaabbbbaaaaaaaaaaaaaabbbbaabaaaaabaaabbbbbbbaaaaabbaaabbaaaaaaaaabbaabaaaaaaaaaaaaaaaaaa
aabbbaaaaaabbbbbaabaaaaaaabbbabbbbbbbaabaaaabaaaabbabbbaabbbbbbbbbaaaaaaaaaabbbaabbaaaaaaaaaaaaaaaaa
aabbbaaaaabbabbaaabaaaaaabaaaaaabbbbabbaaaaaaaaaaaaabbbbbaaaaabbaaaaaaaaaaaabbbaabbaaaaaaaaaaaaaaaaa
aaaabaaaababbbaaabbaaaaaaaaaaaabbaabbabaaaabaaaaaaaaaabaaaaaaaaaaaaaaaaaraababaaabbaaaaabbbbbbaaaaaa
aababaaaaaabbbaabaaaaaaaabaaaaabbabbaaabbbbaaaaaaaaaaabaaaaaaaaaaaaaaarrrrababbbbbbbbbbbbbbbaabaaaaa
aababbaaabbbbbbbbaaaaaaabaaaaaabaabbaaaaaaaaaaaaaaaaaabbaaaaaaaaaaaaarrrrrabbabbbaaaaaabababbbbaaaaa
aaababaaabbbbbbaabaaaaaabaaaaaababbabaaaaaaaaaaaaaaaabbbbbbaaaaaaaaarrrrrrraaaaaaaaaaabaababbbaaaaaa
aaaaabaaabbbaaabbbbaaabbaaaaaaababbbbaaaaabbaaaaaaaabbaaabbbaaaaaarrrrrdrrrraaaaaaaaaabaababbbaaaaaa
aaaaabbbbbbbaaaaaaabbbaaaaaaaaabbabbaaaaababaaaaaaabbaaaababaaaaaarrrerdeerraaaaaaaaaabaababbaaaaaaa
aaaaaaaaaaaaaaaaaaaaaaaaaaaaaaaabbbbaaaaababaaaaaabbbaaabbbbaaaaaarreeddeeerraaaaaaaaaabababbaaaaaaa
aaaaaaaaaaaaaaaaaaaaaaaaaaaaaaaaabaaaaabbaaaaaaaaaaabaabbabbaaaaaaareeddeeerraabbbbabbbbaabaaaaaaaaa
aaaaaaaaaaaaaaaaaaaaaaaaaaaaaaaaabababaaaaabaaaaaaaabbbaaabaaaaaaaareeddeeerrrbaaabbbaaaaaaaaaaaaaaa
aaaaaaaaaaaaaaaaaaaaaaaaaaaaaaaabbbaaaaaaabbaaaaaaaaaaaaaaaaaaaaaaarerrdeeeerrbaabaabaaaabbaabbaaaaa
aaaaaaaaaaabbaaaabbbbbaabbbbbabbabaaaaaaaabaaaaaaaaaaaaaaaaaaaaaaarrrrdrdeeerrraabbbbaaaaabbbbbbaaaa
aaaaaaaaaabbbbbbbbbabbbbbbbbaaaaaaabaaaaabbaaaaaaaaaaaaaaaaaaaaaaaeerededreeerrabbabbbaaaabbbbbbaaaa
aaaaaaaaaabbbabbaaaaaaaabbbbaaaaaaaabaaabbaaaaaaaaaaaaaaaaaaaaaaarerrddrrereerrababbbbbbbbabaaabbaaa
aaaaaaaaababbbbbaaaaaaaaabbbbaaaaaaaababaaaaaaaaaaabaaaaaaaaaaaarredddreerrrerrabbbaababaabbaaabbbaa
bbbaaaabbbbbbaaabbbbbabbbababaaaaaaaaaaaaaaaaabaabbbaaaaaaaarrrredddrrereeeeerrabbaaababaabbaaabbbaa
baababbbbbbbbbabbbaaaaaaabbbbaaaaaaaaaaaaaaaabbababbaaaaaaaarddddererrrreerrrroabbaabaabaabbabbaabba
baabbababbaaababaaaaaaaaaaabbaaaaaaaaaaaaaabbbbbaabaaaaaaaaoooooooeorrrrerrrrrooabbbaaabaabbbabbaaaa
babbaabbbbaaaabbaaaaaaaaaaaaaaaaaaaaabbaaababbaaabbaaaaaaaoooooooooooooorrrrroooaaaabbbaababbbabaaaa
bbbaabbabbaaaaaabbaaaaaaaaaaaaaaaaaabbaabbabbaaaabaaaaaaaooooooooooooooooorrooooaaaaaaaabaabbbbaaaaa
bbabbababbaaaaababaaaaaaaaaaaaaaaaabbbabaabbaaaaaaaaaaaaoooooooooooooooooooooooooaaaaaaabaaaaaaaaaaa
abbaaabaabaaaabaabaaaaaaaaaaaaaaaaabbbaaaaaaaaaaaaaaaaaaooooooooooooooooooooooooooaaaaaabaaaaaaaaaaa
aaaaaabaaaaaarrrrrrraaaaaaaaaaaabaaaaaaaaaaaaaaaaaaaaaaooooooooooooooooooooooooooooaaaababbbaaaaaaaa
aaaaaabaaaaarrrrrrrraaaaaaaaaaaabaaaaaaaaaaabbaaaaaaaaaoooooooooooooooooooooooooooooaaaabaabbaaaaaaa
aaaaaabbaaaarrdrrrrraaaaaaaaabaabaaaaaaaaaaabbaabaaaaaooooooooooooooooooooooooooooooaaabbbabaaaaaaaa
aaabbabbaaaarrdrrrrrraaaaaaaabbabaaaaaabbabbbbaaabaaaoooooooooooooooooooooooooooooombbbaabaabbaaaaaa
aaabbbbbbaaardredrrrrraaaaaaaababaaaabbbbbbbbaaababooooooooooooooooooooooooooooooommaabaaababaaaaaaa
aabababbbabbrdreedreerraaaaaaaaabbabbbbbbbbbbaaaaabooooooooooooooooooooooooooooooomaaabaaaabbaaaaaaa
aababaabbbaardrreeeerrrraaaaaaaaaababbaababbaaaababooooooooooooooooooooooooooooooobbaabbaaaabaaaaaaa
aabbaabbbaaaordddrdrddrrraaaaaaaaaaaaaaabbbbaaaaabbmoooooooooooooooooooooooooooooobabbbbbbaabaaaaaaa
aabbababbaaborrrrrrrrdddrrrraaaaaaabaaaaabbbaaaaabbmmooooooooooooooooooooooooooooooabbabbababaaaaaaa
aabbbaabaabaoooorroorrrdddrrrraabbbbbaaaaabbaaaaaabbmooooooooooooooooooooooooooooooobbbabbbbbaaaaaaa
aaaaaaaaaabaooooooooooorrdrrrrrbbbbbabaaaaaaaaaabbaaoooooooooooooooooooooooooooooooooaaaaaabbaaaaaaa
aaaabbbaabaamoooooooooooreeerrrrrrbbbabaaaaaaaaabaoooooooooooooooooooooooooooooooooooaaaaaaabbaaaaaa
aaabbabaabaammoooooooooooorderrrrrrrrrrrrrrrooooooooooooooooooooooooooooooooooooooooobbbbbaaaabaaaaa
aaabbbbbbbaaammmooooooooooodderrrrrrrrrrrrrroooooooooooooooooooooooooooooooooooooooomaaaabaaaabaaaaa
aaabbabbaaaaabmmmoooooooooorrreeeeeeerrrrrrooooooooooooooooooooooooooooooooooooooooomaaaabbbbbabaaaa
aababbbaaabbbbaammoooooooooorrrrrrrreeeerrooooooooooooooooooooooooooooooooooooooooooaaaabbaaaabaaaaa
aababbbbbbbaabaaamooooooooooooooorrrrrrrroooooooooooooooooooooooooooooooooooooooooomaaaaaaaababaaaaa
aabbaabaaaaaabaaaaooooooooooooooooorrrrrroooooooooooooooooooooooooooooooooooooooooomaaaaaabaabbaaaaa
aaaaaaaabbaaabaaoooooooooooooooooooooooooooooooooooooooooooooooooooooooooooooooooomaaaaaaabbbbaaaaaa
aaaaaaabbbaaaabaoooooooooooooooooooooooooooooooooooooooooooooooooooooooooooooooooombaaaaaaaaaaaaaaaa
aaaaaabbbaaaaabooooooooooooooooooooooooooooooooooooooooooooooooooooooooooooooooooobbaaaaaaaaaaaaaaaa
aaaaabbabaaaaaboooooooooooooooooooooooooooooooooooooooooooooooooooooooooooooooooombbaaaaaaaaaaaaaaaa
aaaabbbbbbbbbaoooooooooooooooooooooooooooooooooooooooooooooooooooooooooooooooooommbbbaaaaaaaaaaaaaaa
aaaabbbbbaaaaboooooooooooooooooooooooooooooooooooooooooooooooooooooooooooooooommmabbbabaaaaabbaaaaaa
aaabbbbabbaaaaoooooooooooooooooooooooooooooooooooooooooooooooooooooooooooooooommaaaaaabaaaabbaaaaaaa
aabaabbbbabaaaoooooooooooooooooooooooooooooooooooooooooooooooooooooommmoooooooaaaaaaaabaaabbaaaaaaaa
aababbaaabbaaoooooooooooooooooooooooooooooooooooooooooooooooooooooommmmmmoooooaaaaaaaabaabbbaaaaaaaa
abaabaaaabbbooooooooooooooooooooooooooooooooooooooooooooooooooooommmmmmmmeoommaaaaaaaababbbaaaaaaaaa
abaaaaaabbboooooooooooooooooooooooooooooooooooooooooooooooooommmmmmmmrrmmemmmmaaaaaaaabbbbaaaaaaaaaa
aabaaaabaaboooooooooooooooooooooooooooooooooooooooooooooooooommmmmmmrrrdddmmmaaaaaaaaabbbaaaaaaaaaaa
aaabaaabaaaoooooooooooooooooooooooooooooooooooooooooooooooooorrrrrrrrrrdaaaaaaaaaaaaaaaabaaaaaaaaaaa
aaaabbbaaaaoooooooooooooooooooooooooooooooooooooooooooooooooorrrrrrrrrraaaaaaaaaaaaaaaabaaaaaaaaaaaa
aaaaaaaaaaaoooooooooooooooooooooooooooooooooooooooooooooooooorrrrrrrrraaaaaaaaaaaaaaaaabaaabbaaaaaaa
aaaabaaaaabooooooooooooooooooooooooooooooooooooooooooooooooooarrrrrraaaaaaaaaaaaaaaaaaabbbbbbaaaaaaa
aaabbaaabbaooooooooooooooooooooooooooooooooooooooooooooooooooaaaaaaaaaaaaaaaaaaaaaaaaabbaaabaaabaaaa
aaabbaaabaaooooooooooooooooooooooooooooooooooooooooooooooooooaaaaaaaaaaaaaaaabbaaaaabbbbaabbaabaaaaa
aaabbaabaaaooooooooooooooooooooooooooooooooooooooooooooooooooaaaaaaaaaaaaaaabbaaaaabababaabaabbaaaaa
aaabbaabaaoooooooooooooooooooooooooooooooooooooooooooooooooooaaaaaaaaaaaaaabbaaaaabbbababbaaabaaaaaa
aaabaaabaooooooooooooooooooooooooooooooooooooooooooooooooooooaaaaaabaaaaaabbaaaabbabaababbaabaaaaaaa
aaabbbaooooooooooooooooooooooooooooooooooooooooooooooooooooooaaaaaabaaaabbbaaaaabaabaabbababbabbaaaa
aaabaaaooooooooooooooooooooooooooooooooooooooooooooooooooooooaaaaaabaaabbbbaaaaaaabaaabbbabaaabaaaaa
aabbbboooooooooooooooooooooooooooooooooooooooooooooooooooooooaaaaabaaabbbbaaaaaaabbaabbbabaaaabaaaaa
aabbaboooooooooooooooooooooooooooooooooooooooooooooooooooooooaaaabbaabbbbaaaaaaaabbbbabaabbaabbaaaaa
aabaaooooooooooooooooooooooooooooooooooooooooooooooooooooooomaaaababbbbbaaaaaaaaaabaabbbbbbaaabbaaaa
aabaaoooooooooooooooooooooooooooooooooooooooooooooooooooooommaaaabbaabaaaaabaaaaabaaabbaaabaaabaaaba
aaaaaoooooooooooooooooooooooooooooooooooooooooooooooooooooomaaaaaaaaaaaaaaabaaaabaaaaaaaaabaabaaaaab
aaaaaooooooooooooooooooooooooooooooooooooooooooooooooooooomaaaaaaaaaaaaaaabaaaabaaaaaaaaaabaabaaaaaa
aaaaaoooooooooooooooooooooooooooooooooooooooooooooooooooommaaaaaaaaaaaaaaabaabbbaaaaaaaaaabaabaaaaaa
aaaaamooooooooommmooooooooooooooooooooooooommmooooooooooomaaaaaaaaaaaaaaaabbbbbaaaaaaaaaaabaabaaaaaa
aaaabmmmmoooommmmmmoooopppoooooooooooooooommmmmooooooooomaaaaaabaaaaaaaaabbbbbbaaaaabaaabbbbbbaaaaaa
aaabbbmmmmoommmmmmmooopppppooommmmmmmmmmmmmmmmmmmmooooommaaaaabbaaaaaaaaaaabbabbbbbbbabaaabbbaaaaaaa
aaabbbbbmmmmmmmrrmmmopppppppommmmmmmmmmmmmmmrmmmmmmommmmaaaaabbaaaaaaaaaaaabaaaabaababaabbbbbaaaaaaa
aabaabbbbmmmmddrrrmmmmmmemmmmmmmrrrrrrmmmmrrrrrrrrmmmmmaaaaaabaabbaaaaaaaaaaaaaabbababbbbbbbbaaaaaaa
aabbbaabbbbddddrrrrmmmmmemmmmmmrddrrrrrrrrrrrrrrrrmmmaaaaaaabbbbbbaaaaaaaaaaababbabbbabbabbabaaaaaaa
abbaaaabaaaabaarerrrrrrrqrrrrrrrdddedddrrrreerrraaaaaaaaaaaaaaaabbaaaaaaaaaabbbaaaaaababbaaabaaaaaaa
bbbbbabbaaaabaaareerrrrrrrrrrrerrdrrrreddrreerraaaaaaaaaaaaaaaaabaaaaaaaabbbbaaaaaabbabbaaaabaaaaaaa
aaaababaaaaaabaaareeerrrrrrrrerddrraarrrerrerraaaaaaaaaaaaaaaaabaaaaaaaabbbbaaaaaabbbbaaaaaabaaaaaaa
aaaababaaaaaabaaaarrreeeerrreddraaaaaarrrererraaaaaaaaaaaaaaaaabbbbbbabbbbbbaaaaaabbaaaaaaabaaaaaaab
aaaabbaaaaaaabaaaarrrrrerrreerraaaaaaaaarreerraaaaaaaaaaaaaaaaaaaaaaaaaaabbaaaaaaaabaaaaaabbaaaabbba
aaaabbaaaaaaaabaabbbrrrrereeerraaaaaaaaaarrrrraaaaaaaaaaaaaaaaaaaaaaababbbaaaaaaaaaababbbbbbaaabaaaa
aaaabaaaaaaaaabbbaaaaarreerrrraaaaaaaaaaarrrrraaaaaaaaaaaaabbbabbabbbbbbaaaaaaaaaaaabbbbabbaaabaaaaa
aaabaaaaaaaaaaaaaaaaaarrrrrrrraaaaaaaaaaarrrrraaaaaaaaaabbbbbbbbbbaaaaaaaaaaaaaaabbbbbabbbaaabaaaaaa
aaabaaaaaaaaaaaaaaaaaaarrrrrraaaaaaaaaaaaarrraaaaaaaaaabaaaaaaaaaaaaaaaaaaaaaaaabbbbaabbbababaaaaaaa
aabbaaaaaaaaabaaaaaaaaaaaaaaaaaaaaaaaaaaaaaaaaaaaaaaaabaaaaaaaaaaaaaaaaaaaaaaaaabbbaaabbbbaaaaaaaaaa
aabbaaaaabbbbbaaaaaaaaaaaaaaaaaaaaaaaaaaaaaaaaaaaaaaabaaaaaaaabbbbbbbaaaaaabbaababaaabbbaaaaaaaaaaaa
abaabbbbbaaabaaabaaaaaaaaaaaaaaaaaaaaaaaaaaaaaaaaaaabaaaaaabbbbaaaaabbabbbaabbaabbaaabaaaaaaaaaaaaaa
baabbaaaaaabbabbbaaaaaaaaaaaaaaaaaaaaaaaabbbbbaaabbbaaaaabbbbaaabbabbabbbbbbbaabaaaabaaaaaaaaaaaaaaa
bbbabaaaaabbbbaabaaaabbbaaaaaaaaaaaabbbabaaabbabbbbaaaaaaabbbbbaaabbaaaaaaabaabbaaaabbbbbbbbaaaaaaaa
baaabbaaabbbbaaabbbbbaaaaaabaaaaaaaabbbbbbbbbbbbababbbbaaaaaaaabbabbbbaaaabbbbaaaaabbbbababaaaaaaaaa
aaaaabbbbbbbaabbbbabbabbabbbbaaaaaaabbaaaabbbbbbbbaabbbbbaaabbbbbbaaabbaababbabbbbbabbabbbbaaaaaaaaa
aaaaaaabbbbbbbbbabbabbbbbbbaaaaaaabbbaaaaaaaaaabbabbbbbaabababbbbaaaababbbbbbbaaaaabbababbaaaaaaaaaa
aaaaaaabbaaaaaaaabaaabbbaabbbbbbbbaaaaaaaaaaaababbbabbbbbaaaaaaaaaaaabaaabbaaaaaabbbbbababaaaaaaaaaa
aaaaaaaaaaaaaaaaabbbbaaaaaaaaabbaaaaaaaaaaabbbbbbaaaaaaaaaaaaaaaaaaaaaaabbaaaaaabbbbbbbbbbaaaaaaaaaa
"}
